111000000111
000111111000
000000100000
000000100000
000111111000
111000000111
000000000000