000001100000
000011110000
000111111000
000011110000
000001100000