100001100001
010011110010
000111111000
010011110010
100001100001
000000000000
000000000000